00000000000000000000000000000000000000000000000000000000000000000000000000000000000000000000000000000000000000000000000000000000000000000000000000000000000000000000000000000000000000000000000000000000000000000000
00000000000000000000000000000000000000000000000000000000000000000000000000000000000000000000000000000000000000000000000000000000000000000000000000000000000000000000000000000000000000000000000000000000000000000000
00000000000000000000000000000000000000000000000000000000000000000000000000000000000000000000000000000000000000000000000000000000000000000000000000000000000000000000000000000000000000000000000000000000000000000000
00000000000000000000000000000000000000000000000000000000000000000000000000000000000000000000000000000000000000000000000000000000000000000000000000000000000000000000000000000000000000000000000000000000000000000000
00000000000000000000000000000000000000000000000000000000000000000000000000000000000000000000000000000000000000000000000000000000000000000000000000000000000000000000000000000000000000000000000000000000000000000000
00000000000000000000000000000000000000000000000000000000000000000000000000000000000000000000000000000000000000000000000000000000000000000000000000000000000000000000000000000000000000000000000000000000000000000000
00000000000000000000000000000000000000000000000000000000000000000000000000000000000000000000000000000000000000000000000000000000000000000000000000000000000000000000000000000000000000000000000000000000000000000000
00000000000000000000000000000000000000000000000000000000000000000000000000000000000000000000000000000000000000000000000000000000000000000000000000000000000000000000000000000000000000000000000000000000000000000000
00000000000000000000000000000000000000000000000000000000000000000000000000000000000000000000000000000000000000000000000000000000000000000000000000000000000000000000000000000000000000000000000000000000000000000000
00000000000000000000000000222200000000000000000000000000000000000022220000000000000000000000000000000000000000222200000000000000000000000000000000000000002222000000000000000000000000000000000000000022200000000000
000000000000000000000000000000000011111111111!1110000000000000000000000000111111111111111!111000000000000000000000000011A111ç11111111!1111100000000000000000000000111111ç11111111!1111*11110000000000000000000000000
0000000000000000000000111111111111!1111110000000000000000000001111111111111111!1111110000000000000000000001111111111111111!1111110000000000000000000001111111111111111!111111111100000000000000000!00000000000000000
P111111111111111!1111111!1111111!1111111!1111111!1111333!3311111!1111111!1111111!1111111!1111111dddd1111!xxxxxxx!xx11111!1111111!1111111!111dddd!1111111!1111333!3311111!1111111!1111111!111dddd!1111111!11111111F11
11111111111111111111111111111111111111111111111111111111111111111111111111111111111111111111111111111111111111111111111111111111111111111111111111111111111111111111111111111111111111111111111111111111111111111111
