00000000000000000000000000000000000000000000000000000000000000000000000000000000000000000000000000000000000000000000000000000000000000000000000000000000000000000000000000000000000000000000000000000000000000000000
00000000000000000000000000000000000000000000000000000000000000000000000000000000000000000000000000000000000000000000000000000000000000000000000000000000000000000000000000000000000000000000000000000000000000000000
00000000000000000000000000000000000000000000000000000000000000000000000000000000000000000000000000000000000000000000000000000000000000000000000000000000000000000000000000000000000000000000000000000000000000000000
00000000000000000000000000000000000000000000000000000000000000000000000000000000000000000000000000000000000000000000000000000000000000000000000000000000000000000000000000000000000000000000000000000000000000000000
00000000000000000000000000000000000000000000000000000000000000000000000000000000000000000000000000000000000000000000000000000000000000000000000000000000000000000000000000000000000000000000000000000000000000000000
00000000000000000000000000000000000000000000000000000000000000000000000000000000000000000000000000000000000000000000000000000000000000000000000000000000000000000000000000000000000000000000000000000000000000000000
00000000000000000000000000000000000000000000000000000000000000000000000000000000000000000000000000000000000000000000000000000000000000000000000000000000000000000000000000000000000000000000000000000000000000000000
0000000000000000000000000000000000000000000000000000000000000000000000000000000000000000000000000000000000000000000000000000000*000000000000000000000000000000000000000000000000000000000000000000000000000000000000
0000000000000000000000000000000000000000000000000000000000000000000000000000000000000000000000000000000000000000000000000000000100000000000000000000000000000000000000000000000000000000000000000000000000000000000F
0000000*0000000000000000000000000000000000000000000000000000222200000000000000000000000000000000000000000000000*000000000000001110000000000000000000000000000000000000000000000000000000000000000!222000000000010001
000000010000000000000000000000000000000000000*00000000000001111110000000000G0000*000000000000000000002ç2202000111000000000000111110000000000000000000000000000000000!000A00!0000000000000000000011111110000001000000
00000010100000000040000000000000000000000000111000000000100000d0000x000000d1000111000000000011000000111111110000000000000000111111100000000000000000d00000000000000011111111100000200000x000100000000000001100000000
P000d10x01020033311100033002033x00x0!0011100000003111000330x00!0000000x000113000!0ç000000000220000300x00000000000000!0000031111111113000000000011100000!0000ç011022000000000030001100000000110!000000000333330000000
11001100011100111111000111111111000111111110000011111111111111111111100111111111111111000111111111111111111111111111110011111111111111100011111111111111100111111111000000001111111110000111111100000011111111000001
