00000000000000000000000000000000000000000000000000000000000000000000000000000000000000000000000000000000000000000000000000000000000000000000000000000000000000000000000000000000000000000000000000000000000000000000
00000000000000000000000000000000000000000000000000000000000000000000000000000000000000000000000000000000000000000000000000000000000000000000000000000000000000000000000000000000000000000000000000000000000000000000
00000000000000000000000000000000000000000000000000000000000000000000000000000000000000000000000000000000000000000000000000000000000000000000000000000000000000000000000000000000000000000000000000000000000000000000
00000000000000000000000000000000000000000000000000000000000000000000000000000000000000000000000000000000000000000000000000000000000000000000000000000000000000000000000000000000000000000000000000000000000000000000
00000000000000000000000000000000000000000000000000000000000000000000000000000000000000000000000000000000000000000000000000000000000000000000000000000000000000000000000000000000000000000000000000000000000000000000
00000000000000000000000000000000000000000000000000000000000000000000000000000000000000000000000000000000000000000000000000000000000000000000000000000000000000000000000000000000000000000000000000000000000000000000
00000000000000000000000000000000000000000000000000000000000000000000000000000000000000000000000000000000000000000000000000000000000000000000000000000000000000000000000000000000000000000000000000000000000000000000
00000000000000000000000000000000000000000000000000000000000000000000000000000000000000000000000000000000000000000000000000000000000000000000000000000000000000000000000000000000000000000000000000000000000000000000
00000000000000000000000000000000000000000000000000000000000000000000000000000000000000000000000000000000000000000000000000000000000000000000000000000000000000000000000000000000000000000000000000000000000000000000
00000000000000000000222000000000000000000000000022200000000000000000000000002220000000000000000000000000000022200000000000000000000000000000222000000000000000000000000000002220000000000000000000000000002220000000
0000000000000000000000000000001111111111!000000000!000000000001111111111!0000000000000000000001A111ç1111!0000000000000000000001111111111!0000000000000!00000001111111111!0000000000000000000001111111111!00000000000
0000000000000000001111111111!1111000000000001111111111!111100000000000001111111111!11110000000000000!0001111111111!1111000000000000000001111111111!11110000000000000000011*1111111!11110000000000000111111111111!110
P11111111111!111!11111111000011111!111!133311111111110000111!111!111111111111111113330000111!111!111111111111111111111100001!111!331111111111111111111!111!1100001111111111111333111!111!111111111111111!11111!11F11
11111111111111111111111111111111111111111111111111111111111111111111111111111111111111111111111111111111111111111111111111111111111111111111111111111111111111111111111111111111111111111111111111111111111111111111
