00000000000000000000000000000000000000000000000000000000000000000000000000000000000000000000000000000000000000000000000000000000000000000000000000000000000000000000000000000000000000000000000000000000000000000000
00000000000000000000000000000000000000000000000000000000000000000000000000000000000000000000000000000000000000000000000000000000000000000000000000000000000000000000000000000000000000000000000000000000000000000000
00000000000000000000000000000000000000000000000000000000000000000000000000000000000000000000000000000000000000000000000000000000000000000000000000000000000000000000000000000000000000000000000000000000000000000000
00000000000000000000000000000000000000000000000000000000000000000000000000000000000000000000000000000000000000000000000000000000000000000000000000000000000000000000000000000000000000000000000000000000000000000000
00000000000000000000000000000000000000000000000000000000000000000000000000000000000000000000000000000000000000000000000000000000000000000000000000000000000000000000000000000000000000000000000000000000000000000000
00000000000000000000000000000000000000000000000000000000000000000000000000000000000000000000000000000000000000000000000000000000000000000000000000000000000000000000000000000000000000000000000000000000000000000000
00000000000000000000000000000000000000000000000000000000000000000000000000000000000000000000000000000000000000000000000000000000000000000000000000000000000000000000000000000000000000000000000000000000000000000000
00000000000000000000000000000000000000000000000000000000000000000000000000000000000000000000000000000000000000000000000000000000000000000000000000000000000000000000000000000000000000000000000000000000000000000000
00000000000000000000000000000000000000000000000000000000000000000000000000000000000000000000000000000000000000000000000000000000000000000000000000000000000000000000000000000000000000000000000000000000000000000000
00000000000000000000000022200000000000000000000000002220000000000000000000000000222000000000000000000000000022200000000000000000000000002220000000000000000000000000000022200000000000000000000000002220000000000000
00000000000000000000000000000000111111111000000000000000000011111111100000000000000000001111111110000000000000000000111111111000000000000000000000001*11111110000000000000000000000011111111100000000000000000000000
000000000000000000001111111111!1100000000000001111111111!110000000S00ç00001111111111!110000000000000!0111111111111!00000000000000000001111111111!11000!00000000000000011111111!11110!000000000001111111111!110000000
P1111111111111!1111xxx!xxxx111!1111111!111111dddddddd111!1111111!1111113333331!1111111!111111111!1111xxxxxxxxxx111!1111111!1111111!11dddddddd11111!1111111!1111111!113333331111111!1111111!111111111111111!111111F11
11111111111111111111111111111111111111111111111111111111111111111111111111111111111111111111111111111111111111111111111111111111111111111111111111111111111111111111111111111111111111111111111111111111111111111111
