00000000000000000000000000000000000000000000000000000000000000000000000000000000000000000000000000000000000000000000000000000000000000000000000000000000000000000000000000000000000000000000000000000000000000000000
00000000000000000000000000000000000000000000000000000000000000000000000000000000000000000000000000000000000000000000000000000000000000000000000000000000000000000000000000000000000000000000000000000000000000000000
00000000000000000000000000000000000000000000000000000000000000000000000000000000000000000000000000000000000000000000000000000000000000000000000000000000000000000000000000000000000000000000000000000000000000000000
00000000000000000000000000000000000000000000000000000000000000000000000000000000000000000000000000000000000000000000000000000000000000000000000000000000000000000000000000000000000000000000000000000000000000000000
00000000000000000000000000000000000000000000000000000000000000000000000000000000000000000000000000000000000000000000000000000000000000000000000000000000000000000000000000000000000000000000000000000000000000000000
00000000000000000000000000000000000000000000000000000000000000000000000000000000000000000000000000000000000000000000000000000000000000000000000000000000000000000000000000000000000000000000000000000000000000000000
00000000000000000000000000000000000000000000000000000000000000000000000000000000000000000000000000000000000000000000000000000000000000000000000000000000000000000000000000000000000000000000000000000000000000000000
00000000000000000000000000000000000000000000000000000000000000000000000000000000000000000000000000000000000000000000000000000000000000000000000000000000000000000000000000000000000000000000000000000000000000000000
00000000000000000000000000000000000000000000000000000000000000000000000000000000000000000000000000000000000000000000000000000000000000000000000000000000000000000000000000000000000000000000000000000000000000000000
00000000000000000000000000002220000000000000000000222000000000000000000000222000000000000000000022200000000000000000000022200000000000000000000000222000000000000000000000222000000000000000000000222000000000000000
00000000000000000000000000000000001111111100000000!0000000111111110000000000000000111111110000000000!000001111111100000000000000001111111100000000000000001111111100000000000000001111111100000000000000000000000000
00000000000000000000000011111111111000!0000000111111111G1000ç0!00000001111111111100000!00000111111111110000000!00000111111111110*00000!00000001111111111100000!000000011111111111000!0!00000001111111111100000000000
P11111111111111111!1111111!1111000000111!1111111!111111111133331!1111111!111111000000111!1111111!11111111xxxxxx1!1111111!11111111111100001!11111111111!11111111111!11111111333!33111111111!11111111111!1111111111F11
11111111111111111111111111111111111111111111111111111111111111111111111111111111111111111111111111111111111111111111111111111111111111111111111111111111111111111111111111111111111111111111111111111111111111111111
