00000000000000000000000000000000000000000000000000000000000000000000000000000000000000000000000000000000000000000000000000000000000000000000000000000000000000000000000000000000000000000000000000000000000000000000
00000000000000000000000000000000000000000000000000000000000000000000000000000000000000000000000000000000000000000000000000000000000000000000000000000000000000000000000000000000000000000000000000000000000000000000
00000000000000000000000000000000000000000000000000000000000000000000000000000000000000000000000000000000000000000000000000000000000000000000000000000000000000000000000000000000000000000000000000000000000000000000
00000000000000000000000000000000000000000000000000000000000000000000000000000000000000000000000000000000000000000000000000000000000000000000000000000000000000000000000000000000000000000000000000000000000000000000
00000000000000000000000000000000000000000000000000000000000000000000000000000000000000000000000000000000000000000000000000000000000000000000000000000000000000000000000000000000000000000000000000000000000000000000
00000000000000000000000000000000000000000000000000000000000000000000000000000000000000000000000000000000000000000000000000000000000000000000000000000000000000000000000000000000000000000000000000000000000000000000
00000000000000000000000000000000000000000000000000000000000000000000000000000000000000000000000000000000000000000000000000000000000000000000000000000000000000000000000000000000000000000000000000000000000000000000
0000000000000000000000000000000000000000000000000000000000000000000000000000000000000000000000000000000000000000000000000000000*000000000000000000000000000000000000000000000000000000000000000000000000000000000000
00000000000000000000000000000000000000000000000000000000000000000000000000000000000000000000000000000000000000000000000000000001000000000000000000000000000000000000000000000000000000000000000000000000000000000000
000000000000000000000000000000000000000000000000000000000000222200000000000000000000000000000000000000000000000*0000000000000011100000000000000000000000000000000000000000000000000000000000000000222000000000010001
00000000000000000000000000000000000000000000000000000000000111111000000000000000*00000000000000000000202202000111000000000000111110000000000000000000000000000000000!000400!0000000000000000000011111110000001000000
00000000000000000040000000000000000000000000111000000000100000000000000000010001110000000000110000001111111100000000000000001111111000000000000000000000000000000000111111111000000000000000100000000000001100000000
P00000000002000001110003300203300000!0011100000003111000330000!00000000000110000!00000000000220000000000000000000000!00000011111111100000000000111000000000000110000000000000000011000000001100000000000000000000000
11111111111111111111111111111111000111111110000011111111111111111111100111111111111111000111111111111111111111111111111111111111111111111111111111111111100111111111000000001111111110000111111100000011111111000001