00000000000000000000000000000000000000000000000000000000000000000000000000000000000000000000000000000000000000000000000000000000000000000000000000000000000000000000000000000000000000000000000000000000000000000000
00000000000000000000000000000000000000000000000000000000000000000000000000000000000000000000000000000000000000000000000000000000000000000000000000000000000000000000000000000000000000000000000000000000000000000000
00000000000000000000000000000000000000000000000000000000000000000000000000000000000000000000000000000000000000000000000000000000000000000000000000000000000000000000000000000000000000000000000000000000000000000000
00000000000000000000000000000000000000000000000000000000000000000000000000000000000000000000000000000000000000000000000000000000000000000000000000000000000000000000000000000000000000000000000000000000000000000000
00000000000000000000000000000000000000000000000000000000000000000000000000000000000000000000000000000000000000000000000000000000000000000000000000000000000000000000000000000000000000000000000000000000000000000000
00000000000000000000000000000000000000000000000000000000000000000000000000000000000000000000000000000000000000000000000000000000000002222200000000000000000000000000000000000000000000000000000000000000000000000001
00000000000000000000000000000000000000000000000000000000000000000000000000000000000000000000000000000000000000000000000000000000000011111110000000000000000000000000000000000000000000000000000000000000000000000001
000000000000000000000000000000000000000000000000000000000000000000000000000000000000000000000000000000000000000000000000000000000!00000400000!0000000000000000000000002222000000000000020000000000000000000000000001
00000000000000000000000000000000000*00000000000000000000022200000000000000000000000000000000000000000000000000000000000000000000111111111111111000000000000000000000011111100000000000111000000000000000000000000001
0000000000000000000000000000000001111100000000000000000011111000000000000000000*000000000000000000000000000000000000000000000000000000000000000000000000000000000000000000000000330000000000000000000000000000000001
000000000000000000000000000022200000000220000000000000!00000000000!00000002000111000000000000000000000000000000000*000000000110000000000000000000000000000000000000*0000000000011110000000!0000000010000000!00000001
00000200000000000000030100001110000000011100000000000010000000011111000001110000000001000000000001000000000000000111000000000000000000000000000000000000000000000011100000110000000000000111000000010000000110000001
P00011100000!00040001100033300000040000000033323330001100000000000!00000001000!003000100003330001100000000!0000000000000333001000100000033300!0000033300000000!00000000000000000000000000010000033010000000330001101
11111111001111111101111111110000011111000011111111111111000000111111100111111111110001000111111111100011111111110000000111111110001111111111111100011111100111111111111111111111111111100010000111110000111111100001