00000000000000000000000000000000000000000000000000000000000000000000000000000000000000000000000000000000000000000000000000000000000000000000000000000000000000000000000000000000000000000000000000000000000000000000
00000000000000000000000000000000000000000000000000000000000000000000000000000000000000000000000000000000000000000000000000000000000000000000000000000000000000000000000000000000000000000000000000000000000000000000
00000000000000000000000000000000000000000000000000000000000000000000000000000000000000000000000000000000000000000000000000000000000000000000000000000000000000000000000000000000000000000000000000000000000000000000
00000000000000000000000000000000000000000000000000000000000000000000000000000000000000000000000000000000000000000000000000000000000000000000000000000000000000000000000000000000000000000000000000000000000000000000
0000000000000000000000000000000000000000000000!03A3!0000000000000000000000000000000000000000000000000000000000000000000000000000000000000000000000000000000000000000000000000000000000000000000000000000000000000000
00000000000000000000000000000000000000000000011111111000000000000000000000000000000000000000000000000000000000000000000000000000000000000000000000000000000000000000000000000000000000000000000000000000000000000000
000000000000000000000000000000000000000000001000000000002220000000000000000000000000000000000000000000000000000000000000000000000000000000000000000000000000000000ç0000000000000000000000000000000000000000000000000
00000000000000000000000000000000000000*000010000000000011111000000000ç0000000000000000000000000000000000000000000000000000000000000000000000000000000000000000000111100000000000000000000000000000000000000000000000
0000000000000000000000000000000000000010000200000000000000002200000011100000000000000000000000322!200000000000000000000000000000000000000000000000000000000000003022030000000000!0000!000000000000000000000010000000
000000000000000*0000000000000000000001100011100000002200000011000000000000000000000000000000011111100!2300000000100000000000033S330000000000000000000000000000011111111010000000100001000000!30000010000000!10000000
0000000000000011100000000000000000001110000000002000111000000000202000000!000000000000000030!00000001111100002!010000000000001111110000000000000*000000!000000000000000010000000100001020011110000012200000110000000
000000000001000000010000000000001110000x0x0000011100000000000000101000000100d000000000000111110000000000000011101000000000000000000000000x0000011100000110!0000000x000001000000010001111111100000021111000F010000000
P00!0000d00x0!030!000d00x00d011100x0000000d000030!000330000ç0300101000000100333**3ç3000001!0000000!030030100000!1ç0003332223330000222333222333000000!0011111ç000000000001300000310!00000021*30000!112230033310000000
11111111110111111110111111111000111000011100011111101111100111111010000001111111111110000111111111111111111100011111111111111100001111111111110000011111100111100000000111100001111111000111100011111111111110000000