00000000000000000000000000000000000000000000000000000000000000000000000000000000000000000000000000000000000000000000000000000000000000000000000000000000000000000000000000000000000000000000000000000000000000000000
00000000000000000000000000000000000000000000000000000000000000000000000000000000000000000000000000000000000000000000000000000000000000000000000000000000000000000000000000000000000000000000000000000000000000000000
00000000000000000000000000000000000000000000000000000000000000000000000000000000000000000000000000000000000000000000000000000000000000000000000000000000000000000000000000000000000000000000000000000000000000000000
00000000000000000000000000000000000000000000000000000000000000000000000000000000000000000000000000000000000000000000000000000000000000000000000000000000000000000000000000000000000000000000000000000000000000000000
00000000000000000000000000000000000000000000000000000000000000000000000000000000000000000000000000000000000000000000000000000000000000000000000000000000000000000000000000000000000000000000000000000000000000000000
00000000000000000000000000000000000000000000000000000000000000000000000000000000000000000000000000000000000000000000000000000000001111111111111111011111111111111110000000000000000000000000000000000000000000000000
00000000000000000000000000000000000000000000000000000000000000000000000000000000000000000000000000000000000000000000000000000000011000000000000001111000000000000011000000000000000000000000000000000000000000000000
0000000000000000000000000000000000000000000000000000000000000000000000000000000000000000000000000000000000000000000000000000000011000000000000000011000000000*000001100000000000000000000000000000000000000000000000
00000000000000000000000000000000000000000000000000000000000000000000000000000000000000000000000000000000000000000000000000000000110000000200000000000000002110000001100000000000000000000000000000000000000000000000
000000000000000000000000000000000000000000000000000000000000000000002000*0000000000000000000000000000000000000000000000000000000!!00000011100000000*000000100000000!!00000000002000000000000000000000000000000000000
00000000000000000000000000000A0000000000000000000000000000000000200111000000000000200200020000000000000!00000000000000000000000111100110000d01100111100110000000111111000S0*0011100000!00000000000000000000!00*00000
00000000000000000000000001100000000000000000000000000000000002011110000000000000021101100100100000000001000000000!0000001000011111133333333333333111133333333333331111001111000100131111011*00000000000000111000000F
P0000000000000000000000011100011000!0ç000001x000000000000!30111000000000x00000002111011333331100000*0011101110d0010001131111011111113333333333331111113333333333311111100110000101131111011111110G00!000011111x00001
11111111111111111111111111100011111111111100111111111111111111111111111111111001111111111111111111111111111111111111111111111111111111111111111111111111111111111111111111111111111111110111111111111100111111111111