00000000000000000000000000000000000000000000000000000000000000000000000000000000000000000000000000000000000000000000000000000000000000000000000000000000000000000000000000000000000000000000000000000000000000000000
00000000000000000000000000000000000000000000000000000000000000000000000000000000000000000000000000000000000000000000000000000000000000000000000000000000000000000000000000000000000000000000000000000000000000000000
00000000000000000000000000000000000000000000000000000000000000000000000000000000000000000000000000000000000000000000000000000000000000000000000000000000000000000000000000000000000000000000000000000000000000000000
00000000000000000000000000000000000000000000000000000000000000000000000000000000000000000000000000000000000000000000000000000000000000000000000000000000000000000000000000000000000000000000000000000000000000000000
00000000000000000000000000000000000000000000000000000000000000000000000000000000000000000000000000000000000000000000000000000000000000000000000000000000000000000000000000000000000000000000000000000000000000000000
000000000000000000000000000000000000000000000000000000000000000000000000000000000000000000000000000000000000000000000000000000000000022S2200000000000000000000000000000000000000000000000000000000000000000000000001
00000000000000000000000000000000000000000000000000000000000000000000000000000000000000000000000000000000000000000000000000000000000011111110000000000000000000000000000000000000000000000000000000000000000000000001
000000000000000000000000000000000000000000000000000000000000000000000000000000000000000000000000000000000000000000000000000000000!0000ç000000!0000000000000000000000002222000000000000020000000000000000000000000001
00000000000000000000000000000000000*00000000000000000000022200000000000000000000000000000000000000000000000000000000000000000000111111111111111000000000000000000000011111100000000000111000000000000000000000000001
0000000000000000000000000000000001111100000000000000000011111000000000000000000*000000000000000000000000000000000000000000000000000000000000000000000000000000000000000000000000330000000000000000000000000000000001
000000000000000000000000000022200000000220000000000000!00000000000!00000002000111000000000000000000000000000000000*000000000110000000000000000000000000000000000000*0000030000011110000000!0000000010000000!00000001
0000020000000000x000030100001110000000011100000000000010000000011111000001110000000001000000000001000000000000000111000001100000000000000000000000000000000000000011100000110033000000000111000000010000000110000F01
P00d1110x000!000G0001100033300d0x0G000000003332333ç001100000d00000!00000001000!0030001000033300011000000d0!0000000000000333001000100x00033300!000003330000x000!0000ç0003000!00000000!!000010000033010000000330001101
11111111001111111101111111110000011111000011111111111111000000111111100111111111110001000111111111100011111111110000000111111110001111111111111100011111100111111111111111111111111111100010000111110000111111100001