00000000000000000000000000000000000000000000000000000000000000000000000000000000000000000000000000000000000000000000000000000000000000000000000000000000000000000000000000000000000000000000000000000000000000000000
00000000000000000000000000000000000000000000000000000000000000000000000000000000000000000000000000000000000000000000000000000000000000000000000000000000000000000000000000000000000000000000000000000000000000000000
00000000000000000000000000000000000000000000000000000000000000000000000000000000000000000000000000000000000000000000000000000000000000000000000000000000000000000000000000000000000000000000000000000000000000000000
00000000000000000000000000000000000000000000000000000000000000000000000000000000000000000000000000000000000000000000000000000000000000000000000000000000000000000000000000000000000000000000000000000000000000000000
00000000000000000000000000000000000000000000000000000000000000000000000000000000000000000000000000000000000000000000000000000000000000000000000000000000000000000000000000000000000000000000000000000000000000000000
00000000000000000000000000000000000000000000000000000000000000000000000000000000000000000000000000000000000000000000000000000000000000000000000000000000000000000000000000000000000000000000000000000000000000000000
00000000000000000000000000000000000000000000000000000000000000000000000000000000000000000000000000000000000000000000000000000000000000000000000000000000000000000000000000000000000000000000000000000000000000000000
0000000000000000000000000000000000000000000000000000000000000000000000000000000000000000000000000000000000000000000000000000000*000000000000000000000000000000000000000000000000000000000000000000000000000000000000
00000000000000000000000000000000000000000000000000000000000000000000000000000000000000000000000000000000000000000000000000000001000000000000000000000000000000000000000000000000000000000000000000000000000000000000
0000000*0000000000000000000000000000000000000000000000000000222200000000000000000000000000000000000000000000000*000000000000001110000000000000000000000000000000000000000000000000000000000000000!222000000000010001
000000010000000000000000000000000000000000000*0000000000000111111000000000000000*00000000000000000000202202000111000000000000111110000000000000000000000000000000000!000400!0000000000000000000011111110000001000000
00000010100000000040000000000000000000000000111000000000100000000000000000010001110000000000110000001111111100000000000000001111111000000000000000000000000000000000111111111000002000000000100000000000001100000000
P000d1000102003331110003300203300000!0011100000003111000330000!00000000000113000!00000000000220000300000000000000000!0000031111111113000000000011100000!00000011022000000000030001100000000110!000000000333330000000
11001100011100111111000111111111000111111110000011111111111111111111100111111111111111000111111111111111111111111111110011111111111111100011111111111111100111111111000000001111111110000111111100000011111111000001