00000000000000000000000000000000000000000000000000000000000000000000000000000000000000000000000000000000000000000000000000000000000000000000000000000000000000000000000000000000000000000000000000000000000000000000
00000000000000000000000000000000000000000000000000000000000000000000000000000000000000000000000000000000000000000000000000000000000000000000000000000000000000000000000000000000000000000000000000000000000000000000
00000000000000000000000000000000000000000000000000000000000000000000000000000000000000000000000000000000000000000000000000000000000000000000000000000000000000000000000000000000000000000000000000000000000000000000
00000000000000000000000000000000000000000000000000000000000000000000000000000000000000000000000000000000000000000000000000000000000000000000000000000000000000000000000000000000000000000000000000000000000000000000
0000000000000000000000000000000000000000000000!0343!0000000000000000000000000000000000000000000000000000000000000000000000000000000000000000000000000000000000000000000000000000000000000000000000000000000000000000
00000000000000000000000000000000000000000000011111111000000000000000000000000000000000000000000000000000000000000000000000000000000000000000000000000000000000000000000000000000000000000000000000000000000000000000
00000000000000000000000000000000000000000000100000000000222000000000000000000000000000000000000000000000000000000000000000000000000000000000000000000000000000000000000000000000000000000000000000000000000000000000
00000000000000000000000000000000000000*00001000000000001111100000000000000000000000000000000000000000000000000000000000000000000000000000000000000000000000000000111100000000000000000000000000000000000000000000000
0000000000000000000000000000000000000010000200000000000000002200000011100000000000000000000000322!200000000000000000000000000000000000000000000000000000000000003022030000000000!00000000000000000000000000010000000
000000000000000*0000000000000000000001100011100000002200000011000000000000000000000000000000011111100!23000000001000000000000334330000000000000000000000000000011111111010000000100000000000!30000010000000!10000000
0000000000000011100000000000000000001110000000002000111000000000202000000!000000000000000030!00000001111100002!010000000000001111110000000000000*000000!000000000000000010000000100000020011110000012200000110000000
0000000000010000000100000000000011100000000000011100000000000000101000000100000000000000011111000000000000001110100000000000000000000000000000001000000110!000000000000010000000100011111111000000211110000010000000
P00!0000d0000!030!0000000000011100000000000000030000033000000300101000000100333**333000001!0000000!030030100000!100003332223330000222333222333000000!00111110000000000001300000310!00000021*30000!112230033310000000
11111111110111111110111111111000111000001000011111101111100111111010000001111111111110000111111111111111111100011111111111111100001111111111110000011111100111100000000111100001111111000111100011111111111110000000