00000000000000000000000000000000000000000000000000000000000000000000000000000000000000000000000000000000000000000000000000000000000000000000000000000000000000000000000000000000000000000000000000000000000000000000
00000000000000000000000000000000000000000000000000000000000000000000000000000000000000000000000000000000000000000000000000000000000000000000000000000000000000000000000000000000000000000000000000000000000000000000
000000000000000000000000000000000000000000000000000000000000000000000000000000000000000000000000000000000000000000000000000000000000000000000000000S0000000000000000000000000000000000000000000000000000000000000000
00000000000000000000000000000000000000000000000000000000000000000000000000000000000000000000000000000000000000000000000000000000000000000000000000111000000000000000000000000000000000000000000000000000000000000000
0000000000000000000000000000000000000000000000000000000000000000000000000000000000000000000000000000000000000000000000000000000000000!00!0x00x00303030000x00!00!0000000000000000000000000000000000000000000000000000
000000000000000000000000000000000000000000000000000000000000000000000000000000000000000000000000000000000000000000000000000000000011111111111111110*0111111111111110000000000000000000000000000000000000000000000000
00000000000000000000000000000000000000000000000000000000000000000000000000000000000000000000000000000000000000000000000000000000011000000000000001111000000000000011ç00000200000000000000000000000000000000000000000
0000000000000000000000000000000000000000000000000000000000000000000000000000000000000000000000000000000000000000000000000000000011000000000000000011000000000*000001100001110000000000000000000000000000000000000000
000000000000000000000000000000000000000000000000000000000000000000000000000000000000000000000000000000000000000000000000000ç0000110000000200000000000000002110000001100000000000000000000000000000000000000000000000
000000000000000000000000000000000000000000000000000000000000000000002000*0000000000000000000000000000000000000000000000000111000!!ç0000011100000000*000000100000000!!ç0000000002000000000000000000000000000000000000
00000000000000000000000000000A0000000000000000000000000000000000200111000000000000200200020000000000000!00000000000000000000000111100110000d01100111100110000000111111000S0*00111000x0!00000000000000000000!00*00000
000000000000000001000000!11000000000000000000000000001000000020111100000000000000211011001001ç0000000001000000000!00000010*0011111133330000000033111133033033033031111001111000100131111011*00ç00000000000111000000F
P0000000000000000103333011100011000!0ç000001x000101001000!30111000000000x000300021110113333311x0000*0011101110d0010001131111011111113330333303331111110333030330311111100110000101131111011111110G00!000011111x00001
11111111111000111111111111100011111111111100111111111111111111111111111111111001111111111111111111111111111111111111111111111111111111111111111111111111111111111111111111111111111111110111111111111100111111111111